1111111111111111
1111111111111111
1111111111111111
1111111111111111
1111111111111111
1111111111111111
1111100000011111
1110000000011111
1111111111111111
0000000000011111
1111111111111111
1111111111111111
1111111111111111
0000000000000001
0000000000000001
1111111111111111